************ * ************
*          * * *          *
*          * * *          *
*          * * *          *
*    ******* * *******    *
*    *       *       *    *
*    * ************* *    *
*    * *           * *    *
****** *           * ******
**     *           *     **
** *****           ***** **
** *                   * **
** *     *       *     * **
** ***  * *     * *  *** **
**   * *   *   *   * *   **
**** *      * *      * ****
*  * *       *       * *  *
*  * *      * *      * *  *
*  * *     *   *     * *  *
*  * *    *     *    * *  *
**** *   *       *   * ****
**   *    *     *    *   **
** ***     *   *     *** **
** *        * *        * **
** *         *         * **
** *****           ***** **
**     *           *     **
****** *           * ******
*    * *           * *    *
*    * ************* *    *
*    *       *       *    *
*    ******* * *******    *
*          * * *          *
*          * * *          *
*          * * *          *
************ * ************