************ * ************
*          + + +          *
*          + + +          *
*          + + +          *
*    +++++++ + +++++++    *
*    +       +       +    *
*    + +++++++++++++ +    *
*    + +           + +    *
*+++++ +           + +++++*
*+     +           +     +*
*+ +++++           +++++ +*
*+ +                   + +*
*+ +     *       *     + +*
*+ +++  * *     * *  +++ +*
*+   + *   *   *   * +   +*
*+++ +      * *      + +++*
*  + +       *       + +  *
*  + +      * *      + +  *
*  + +     *   *     + +  *
*  + +    *     *    + +  *
*+++ +   *       *   + +++*
*+   +    *     *    +   +*
*+ +++     *   *     +++ +*
*+ +        * *        + +*
*+ +         *         + +*
*+ +++++           +++++ +*
*+     +           +     +*
*+++++ +           + +++++*
*    + +           + +    *
*    + +++++++++++++ +    *
*    +       +       +    *
*    +++++++ + +++++++    *
*          + + +          *
*          + + +          *
*          + + +          *
************ * ************