* * * * * * * * * * * *   *   * * * * * * * * * * * * 
*                     *   *   *                     * 
*                     *   *   *                     * 
*                     *   *   *                     * 
*         * * * * * * *   *   * * * * * * *         * 
*         *               *               *         * 
*         *   * * * * * * * * * * * * *   *         * 
*         *   *                       *   *         * 
* * * * * *   *                       *   * * * * * * 
* *           *                       *           * * 
* *   * * * * *                       * * * * *   * * 
* *   *                                       *   * * 
* *   *           *               *           *   * * 
* *   * * *     *   *           *   *     * * *   * * 
* *       *   *       *       *       *   *       * * 
* * * *   *             *   *             *   * * * * 
*     *   *               *               *   *     * 
*     *   *             *   *             *   *     * 
*     *   *           *       *           *   *     * 
*     *   *         *           *         *   *     * 
* * * *   *       *               *       *   * * * * 
* *       *         *           *         *       * * 
* *   * * *           *       *           * * *   * * 
* *   *                 *   *                 *   * * 
* *   *                   *                   *   * * 
* *   * * * * *                       * * * * *   * * 
* *           *                       *           * * 
* * * * * *   *                       *   * * * * * * 
*         *   *                       *   *         * 
*         *   * * * * * * * * * * * * *   *         * 
*         *               *               *         * 
*         * * * * * * *   *   * * * * * * *         * 
*                     *   *   *                     * 
*                     *   *   *                     * 
*                     *   *   *                     * 
* * * * * * * * * * * *   *   * * * * * * * * * * * * 